11111111111
1P000000001
10000000001
10000000C0111
100000000011
1000000000111
10000000001
10000011101
1000001E001
11111111111
